Guruló Kalória Étterem
Ételek	

Levesek
Pacal-ízáció – Pacalleves, ami megváltoztatja a világképed
Csípős Kacaj – Erősen fűszeres gulyásleves
Tengerész Könnyei – Halászlé extra paprikával
Erdő Mélye – Gombakrémleves
Főételek
Rakott Kockahas – Rakott krumpli extra kolbásszal
Csirkés Végzet – Rántott csirkemell dupla adag sült krumplival
Böllér Bosszúja – Extra csípős sertéspörkölt nokedlivel
Bölény Burgonya – Steak sült krumplival
Hal-ló, itt a vacsora! – Rántott hekk fokhagymás majonézzel
Street Food & Gyorsételek
Bunkó Burger – Gigantikus hamburger, amit lehetetlen szépen enni
Kolbásztrofa – Töltött lángos kolbásszal
Tészta-lázadás – Extra sajtos mac & cheese
Hot-dogmánia – Extra hosszú virsli, amit alig bírsz megfogni
Desszertek
Kakaó-Kommandó – Duplacsokis brownie
Palacsinta Paradicsom – Óriáspalacsinta mindennel, ami belefér
Gombóc Artúr kedvence – Fagylaltkehely minden ízzel
Édes Bűnbeesés – Somlói galuska extra habbal


Italok
Alkoholmentes italok
H2Ó de Finom – Jeges víz citromkarikával
Koffein Katasztrófa – Extra erős feketekávé
Tej-hatalom – Jeges tej shake vaníliával
Buborék Buli – Szénsavas üdítő, amitől felpezsdülsz
Vitamin Bomba – Frissen facsart narancslé
Gyümölcsosztag – Vegyes smoothie minden földi jóval
Málnás Zúzda – Jeges málna limonádé
Koktélok & Alkoholos italok
Bumm, Bele! – Erős rumos koktél gyümölcslével
Csípős Reggel – Bloody Mary extra csilivel
Csak Egyet Iszom – Long Island Iced Tea (amiből sosem csak egy lesz...)
Mámoros Esték – Édes, likőrös kávékoktél
Neonfröccs – Fluoreszkálóan színes kevert ital
Pirítós Pálinka – Extra erős házi pálinka
Titkos Recept – Egyedi keverésű házi koktél
